3,0,0,0,0,0,0
0,1,1,0,1,1,0
0,0,6,0,5,0,0
0,1,0,4,0,1,0
0,0,5,1,6,0,0
0,1,0,0,0,1,0
0,0,0,0,0,0,0
0,0,0,0,0,0,0
0,0,0,2,0,0,0
