0,0,0,0,0
0,0,0,0,0
0,0,0,0,0
1,1,4,0,3
0,0,0,0,0
0,0,0,0,0
0,0,2,0,0
